[
  {
    "type": 0,
    "templates":[
      [
        "WWEEWWWW",
        "WWEEEWWW",
        "WWEWWWEE",
        "WWEWWWEE",
        "WWEEWWEE",
        "WWWWWWWW"
      ],
      [
        "WWWEEWWW",
        "WWEEWWWW",
        "EWWEEWWE",
        "EWWEWWEE",
        "EWWWWWWW",
        "WWWWWWWW"
      ],
      [
        "WWWEEWWW",
        "WWEWEEWW",
        "WWEWWWWW",
        "WWEEWEWW",
        "WWWWEEWW",
        "WWEEEWWW"
      ],
      [
        "WWWEEEWW",
        "EEWEEEWW",
        "EWWEWWWW",
        "WWWWWWWW",
        "WWEEEEWW",
        "WWEEWWWW"
      ]
    ]
  },
  {
    "type": 1,
    "templates":[
      [
        "WWWWWWWW",
        "WWEEEWWW",
        "WWEWWWEE",
        "WWEEEEEE",
        "WWEEEEEE",
        "WWWWWWWW"
      ],
      [
        "WWWWWWWW",
        "WWEEWWWW",
        "EWWEEWWE",
        "EEEEEWEE",
        "EWWWEWWW",
        "WWWWWWWW"
      ],
      [
        "WWWWWWWW",
        "WWEWWWWW",
        "WWEEEEWW",
        "WWEEWEWW",
        "WWEEWEWW",
        "WWEEWWWW"
      ],
      [
        "WWWEEEWW",
        "WWWWWEWW",
        "EWWEWWWW",
        "EEEEWWWW",
        "WWEEEEWW",
        "WWWWWWWW"
      ]
    ]
  },
  {
    "type": 2,
    "templates":[
      [
        "WWWWWWWW",
        "WWWEEWWW",
        "WWEEEEEE",
        "EEEEEEEE",
        "WWEEEEEE",
        "WWWWWWWW"
      ],
      [
        "WWWWWWWW",
        "WWEEEEEE",
        "EEEEEEEE",
        "EEEEEWWE",
        "EWWWEEWW",
        "WWWWWWWW"
      ],
      [
        "WWWWWWWW",
        "WWEEWWWW",
        "EWEEEEWE",
        "EEEEWEEE",
        "WWEEWEEE",
        "WWWWWWWW"
      ],
      [
        "WWWWWWWW",
        "WWEEEEWW",
        "EEEEWWWE",
        "EEEEWWEE",
        "WWEEEEEE",
        "WWWWWWWW"
      ]
    ]
  },
  {
    "type": 3,
    "templates": [
      [
        "WWEEEEWW",
        "WWWEEEWW",
        "EEEEEEEE",
        "EEEEEEEE",
        "WWWWEEWW",
        "WWWWWWWW"
      ],
      [
        "WWEEEWWW",
        "WWWEEWWW",
        "EWWEEEEE",
        "EEEEEWEE",
        "WWEEWWWW",
        "WWWWWWWW"
      ],
      [
        "WWEEEEWW",
        "WWWEEEEW",
        "EEEEEWWE",
        "EEEEWWEE",
        "WWEEEEEE",
        "WWWWWWWW"
      ],
      [
        "WEEEEEEE",
        "WWWEEEWW",
        "EEWEEEEE",
        "EEEEEEEE",
        "WWEEEEWW",
        "WWWWWWWW"
      ]
    ]
  },
  {
    "type": 4,
    "templates": [
      [
        "WWWEWWWW",
        "WWWWWEWW",
        "EEWWEEEE",
        "EEEEEEEE",
        "WWEEEEWW",
        "WWWEEWWW"
      ],
      [
        "WWWWWWWW",
        "WWWEEWWW",
        "EWWEEEEE",
        "EEEEEWEE",
        "WWEEWWWW",
        "WWWEEEWW"
      ],
      [
        "WWWWWWWW",
        "WWWEEWWW",
        "EEEEEEEE",
        "EEEEWWEE",
        "WWEWWWEE",
        "WWEEEWWW"
      ],
      [
        "WEWWWWWW",
        "WWWEEEWW",
        "EEWEEEEE",
        "EEEEEEEE",
        "WWEEEEWW",
        "WEEEEEWW"
      ]
    ]
  },
  {
    "type": 5,
    "templates": [
      [
        "WWWEEEEW",
        "WWWEWEWW",
        "EEWEEEEE",
        "EEEEEEEE",
        "WWEEEEWW",
        "WWEEEEWW"
      ],
      [
        "WEEEEWWW",
        "WWWEEWWW",
        "EWWEEEEE",
        "EEWWEWEE",
        "WEEEEWWW",
        "WWWEEEWW"
      ],
      [
        "WEEEEEEW",
        "WWWEEWWW",
        "EEEEEEEE",
        "EEEEWWEE",
        "WWEEEWEE",
        "WWEEEEEW"
      ],
      [
        "WEEEEEEW",
        "WEEEWWEW",
        "EEEEWEEE",
        "EEEEEEEE",
        "WEEEEEEW",
        "WEEEEEEW"
      ]
    ]
  }
]